0,0,0,0,0,0,0,0,0,0,0,0,0,0,0,0,0,0,0,0,0,0,0,0
0,0,0,0,0,0,0,0,0,0,0,0,0,0,0,0,0,0,0,0,0,0,0,0
0,0,0,0,0,0,0,0,0,0,0,0,0,0,0,0,0,0,0,0,0,0,0,0
0,0,0,0,X,X,X,X,X,X,0,0,0,0,X,X,X,X,X,X,0,0,0,0
0,0,0,0,X,0,0,0,0,0,0,0,0,0,X,0,0,0,0,0,0,0,0,0
0,0,0,0,X,0,0,0,0,0,0,0,0,0,X,0,0,0,0,0,0,0,0,0
0,0,0,0,X,0,0,X,X,X,0,0,0,0,X,0,0,X,X,X,0,0,0,0
0,0,0,0,X,0,0,0,0,X,0,0,0,0,X,0,0,0,0,X,0,0,0,0
0,0,0,0,X,0,0,0,0,X,0,0,0,0,X,0,0,0,0,X,0,0,0,0
0,0,0,0,X,X,X,X,X,X,0,0,0,0,X,X,X,X,X,X,0,0,0,0
0,0,0,0,0,0,0,0,0,0,0,0,0,0,0,0,0,0,0,0,0,0,0,0
0,0,0,0,0,0,0,0,0,0,X,0,0,X,0,0,0,0,0,0,0,0,0,0
0,0,0,0,0,0,0,X,0,0,0,0,0,0,0,0,X,0,0,0,0,0,0,0
0,0,0,0,0,0,0,0,X,0,0,0,0,0,0,X,0,0,0,0,0,0,0,0
0,0,0,0,0,0,0,0,0,X,X,X,X,X,X,0,0,0,0,0,0,0,0,0,0
0,0,0,0,0,0,0,0,0,0,0,0,0,0,0,0,0,0,0,0,0,0,0,0
0,0,0,0,0,0,S,S,S,S,S,S,S,S,S,0,0,0,0,0,0,0,0,0
0,0,0,0,0,0,S,0,0,0,0,0,0,0,S,0,0,0,0,0,0,0,0,0
0,0,0,0,0,0,S,0,0,0,0,0,0,0,S,0,0,0,0,0,0,0,0,0
0,0,0,0,0,0,S,0,0,0,M,0,0,0,S,0,0,0,0,0,0,0,0,0
0,0,0,0,0,0,S,0,0,0,0,0,0,0,S,0,0,0,0,0,0,0,0,0
0,0,0,0,0,0,S,0,0,0,0,0,0,0,S,0,0,0,0,0,0,0,0,0
0,0,0,0,0,0,S,S,S,S,S,S,S,S,S,0,0,0,0,0,0,0,0,0
0,0,0,0,0,0,0,0,0,0,0,0,0,0,0,0,0,0,0,0,0,0,0,0
0,0,0,0,0,0,0,0,0,0,0,0,0,0,0,0,0,0,0,0,0,0,0,0
0,0,0,0,0,0,0,0,0,0,0,0,0,0,0,0,0,0,0,0,0,0,0,0
0,0,0,0,0,0,0,0,0,0,0,0,0,0,0,0,0,0,0,0,0,0,0,0
0,0,0,0,0,0,0,0,0,0,0,0,0,0,0,0,0,0,0,0,0,0,0,0
0,0,0,0,0,0,0,0,0,0,0,0,0,0,0,0,0,0,0,0,0,0,0,0
0,0,0,0,0,0,0,0,0,0,0,0,0,0,0,0,0,0,0,0,0,0,0,0
0,0,0,0,0,0,0,0,0,0,0,0,0,0,0,0,0,0,0,0,0,0,0,0
X,X,X,X,X,X,X,X,X,X,X,X,X,X,X,X,X,X,X,X,X,X,X,X